1.922595764106416425e+02 -1.088499364506444778e+01
1.616476408354769774e+02 -1.090207461677400502e+01
1.157299907689114491e+02 -1.092747849329645859e+01
1.616307366057907302e+02 1.971037614007571648e+01
1.616050514630205157e+02 6.562827168805233669e+01
-4.215895757668216902e+03 -1.329448159754305436e+01
